19
10
23 23 23 23 23 23 23 23 23 23 23 23 23 23 23 23 23 23 23 
23 0 0 0 0 0 0 0 0 0 0 0 0 0 0 0 0 0 23 
23 0 0 0 0 0 0 0 0 0 0 0 0 0 0 0 0 0 23 
23 0 0 0 0 0 0 0 0 0 0 0 0 0 0 0 0 0 23 
23 0 0 0 0 0 0 26 20 20 20 27 0 0 0 0 22 0 23 
23 0 0 0 0 0 0 0 0 0 0 0 0 0 0 0 0 0 23 
23 0 0 26 27 0 0 0 0 0 0 0 0 26 27 0 0 0 23 
23 0 0 0 0 0 0 0 0 0 0 0 0 0 0 0 0 0 23 
23 0 3 0 0 19 20 20 20 20 20 20 21 0 0 0 0 0 23 
23 19 20 20 20 18 18 18 18 18 18 18 18 20 20 20 20 21 23 
